#### ## #########     #######         ###### ## #   #   #####
#### ##             ######### #######    ###      #   # #####
#### ## ########### #########    #######     ### #####B #####
###                       ###### ####    #######        #####
##   ###  ############### ###### ###  ##     ### ###### #####
#  #####  ############### ###### ##  ### #######        #####
  ####### ##############   ####  #  ####     ##  ############
 ######## ##############   #### ## ############# ##### ######
 ###      ########                 ###################     ##
 ### ##########    #####   #############     #############   
  ##      ##### ########   ########          ####    #####   
# ####### ##### ######### ######### ############# ## ##### ##
# #######       ######### ##        #####         ## ##### ##
# ####################       #######      ########## ##### ##
  #################### ############# ############### ##### ##
# #######   ########## ######        #               ##### ##
# ######  # ##         ###################### ############ ##
# ####   ##    ############################## ############ ##
# ##    ####################  ###########     ###########  ##
#    ## ####################  ########        ######      ###
# ##### ####################  ######## ############# ########
#  #### ########        ####  ######## ##########       #####
## #### ####     ###### ####  ######## ############# ########
##           ###        ####  ####        ########## ########
## #####  ####   ###########  ###  ###### ########## ########
##  ###    ##### ########         ###  ## ########## ########
### #####  #####          ##### ##     ##               #####
###A##### ####################     ##  ##############   #####
##################################################### #######
