#####################
#B                  #
# ##### ##### ##### #
# #   #     #       #
# # # ### ######### #
#   #   #       #   #
##### ##### ##### # #
#   # #       #   # #
# ### ##### ##### # #
#       #   #     # #
### ### # # # ##### #
#   #   # # #     # #
# # ####### ####### #
# #           #     #
# ### ##### # ##### #
#     #   #   #   # #
# ##### # ### # ### #
#       #          ##
################## A#
