#######B#
####    #
#### ####
#### ####
     ####
A########
#########
#########
