###########         #########
#        ################   #
# ####                # # # #
# ################### # # # #
#                     # # # #
##################### # # # #
#   ##                # # # #
# # ## ### ## ######### # # #
# #    #   B##          # # #
# # ## ################ # # #
### ##             #### # # #
### ############## ## # # # #
###             ##A   # # # #
###### ######## ####### # # #
###### ####             #   #
#############################
